        NO              textures/grey_stone.xpm   
SO textures/purple_stone.xpm                 
WE              textures/red_brick.xpm
 EA  textures/black_brick.xpm 

      


F 18,    53,   25    
C 153,     204,    255    









11111111
10101001
10011001
100N1001
10100101
10000011
1000010111111111111111111111111111111111111111111111111111111111111111111111111111111111111111111111111111111111111111111111
1N00000000000000000000000000000000000000000000000000000000000001000000000000000000000000000000000000000000000000000000000011
1000000111111111111111111111111111111111111111111111111111111111111111111111111111111111111111111111111111111111111111111111
10000001
11000001
11100001
11110001
11111001
11111101
11111111