        NO              textures/grey_stone.xpm   
SO textures/purple_stone.xpm                 
WE              textures/red_brick.xpm
 EA  textures/black_brick.xpm 

      


F 18,    53,   25    
C 153,     204,    255    









1111111
10101001
10101001
10101001
10101001
11101111
1010100111111111111111111111111
100S0000000000000000000001
1001000111111111111111111111111
1111111