        NO              textures/grey_stone.xpm   
SO textures/purple_stone.xpm                 
WE              textures/red_brick.xpm
 EA  textures/black_brick.xpm 

      


F 200,    22,   190  
C 153,     204,    255    









11111111
10101001
10011001
10001001
10100101
111111001111
1000000111111111111111111111111111111111111111111111111111111111111111111111111111111111111111111111111111111111111111111111
1N00000111000000000000000000000000000000000000000000000000000001000000000000000000000000000000000000000000000000000000000011
1000000111111111111111111111111111111111111111111111111111111111111111111111111111111111111111111111111111111111111111111111
11111101
11000001
11100001
11110001
11111001
11111101
11111111