        NO              textures/wall_1.xpm   
SO textures/wall_2.xpm                
WE              textures/wall_3.xpm
 EA  textures/wall_4.xpm 

      


F 200,    22,   190  
C 153,     204,    255    









11111111
10101001
10000001
10000001
10100101
111N11001111
1000000111111111111111111111111111111111111111111111111111111111111111111111111111111111111111111111111111111111111111111111
1000000111000000000000000000000000000000000000000000000000000001000000000000000000000000000000000000000000000000000000000011
1000000111111111111111111111111111111111111111111111111111111111111111111111111111111111111111111111111111111111111111111111
11111101
11000001
11100001
11110001
11111001
11111101
11111111