        NO              textures/grey_stone.xpm   
SO textures/purple_stone.xpm                 
WE              textures/red_brick.xpm
 EA  textures/black_brick.xpm 

      


F 18,    53,   25    
C 153,     204,    255    









111111111111
111111111101
101010000001
101010000001
101010000001
101010000001
101010000001
100N00000001
100000000001
100000000001
100000010011
100000010001
111111111111