        NO              textures/wall_1.xpm   
SO textures/purple_stone.xpm                 
WE              textures/red_brick.xpm
 EA  textures/black_brick.xpm 

      


F 150,    110,   70    
C 230,     240,    250    









111111111111
100000100001
100000101101
100000000101
100000000101
10000N000101
100000000101
111110000101
100000010001
101111110101
101111000101
100000011001
111111111111