        NO              textures/wall_5.xpm   
SO textures/wall_2.xpm                 
WE              textures/wall_3.xpm
 EA  textures/wall_4.xpm 

      


F 150,    110,   70    
C 230,     240,    250    









111111111111
100000000001
100000001101
100N00000101
100001000101
100000000101
100000000101
100000000101
100000010001
101111110101
101111000101
100000011001
111111111111