        NO              textures/jail_1.xpm   
SO textures/wall_0.xpm                 
WE              textures/wall_6.xpm
 EA  textures/wall_4.xpm 

      


F 150,    110,   70    
C 230,     240,    250    









11111111111
100000000001
100000000001
100101011001
100010100001
100001000001
100000000001
100000000001
100000000001
101S00000101
100100000101
100000011001
111111111111