        NO              textures/wall_7.xpm   
SO textures/wall_2.xpm                 
WE              textures/wall_3.xpm
 EA  textures/wall_4.xpm 

      


F 150,    110,   70    
C 230,     240,    250    









111111111111
100000000001
100000000001
100111111001
10000N100001
100000100001
100000000001
100000000001
100000000001
100000000101
100000000101
100000011001
111111111111