NO textures/grey_stone.xpm
SO textures/purple_stone.xpm
WE textures/red_brick.xpm
EA textures/black_brick.xpm

      


F 18,    53,   25
C 153,     204,    255









11111111
1111100001
100000011001
111000001111
10S000000001
111111000001
110000000001
111111111111