        NO              textures/grey_stone.xpm   
SO textures/purple_stone.xpm                 
WE              textures/red_brick.xpm
 EA  textures/black_brick.xpm 

      


F 18,              53,   25    
C                 153,     204,                                             255     




1111111111111111111111111111111111111111111111111111111111111111111111111111111111111
1111111111111111111111111111111111111011111111111111111111111111111111111111111111111
1111111111111111111111111111111111111011111111111111111111111111111111111111111
1100000000000000000000000000000000000011111111111111111111111111111111111111111111111111
11111111111111111111111111111111111110111111111111111111111111111111111111111111111
111111111111111111111111111111111111101111111111111111111111111111111111111
11111111111111111111111111111111111110111111111111111111111111111111111111111111
11111111111111111111111111111111111110111111111111111111111111111111111111111
111111111111111111111111111111111111101111111111111111111111111111111111111111111
111111111111111111111111111111111111101111111111111111111111111111111111111111111111111111
1111111111111111111111111111111111111000000000000000000000000000000000000000000N0000000111
111111111111111111111111111000111111101111111111111111111111111111111111111111111111111111
1111111111111111111111111110000000000000000000000000000111111111111111111111
1111111111111111111111111110001111111111111111111111111111111111111111111111
1111111111111111111111111111011111111111111111111111111111111111111111111111
111111111111111111111111111101111111111111111111111111111111111111111111111111111111
1111111111111111111111111111011111111111111111111111111111111111111111
1111111111111111111111111111011111111111111111111111111111111111111111
11111111111111111111111111110111111111111111111111111111111111111111111111111111111
1111111111111111111111111111011111111111111111111111111111111111111111111111
1111111111111111111111111111011111111111111111111111111111111111111111111111111111111
11111111111111111111111111110000000000000000000000000111111111111111111111111
1111111111111111111111111111000000000000000000000000000000011111111111
111111111111111111111111111101111111111111111111111111111111111111111111111111
111111111111111111111111111101111111111111111111111111111111111111111111111111
11111111111111111111111111110111111111111111111111111111111111111111111111
1111111111111111111111111111111111111111111111111111111111111111111111111111111111
1111111111111111111                                             1111111111111111111
1111111111111111111 1111111111111111111111111111111111111111111 11111111111111111
1111111111111111111 11                                       11 1111111111111111
1111111111111111111 111111111111111111111111111111111 111111 11 11111111111111111
1111111111111111111 111111111111111111111111111111111 111111 11 111111111111111111111
1111111111111111111 111111111111111111111111111111111 111111 11 111111111111111111
1111111111111111111 11111                             111111 11 1111111111111111
1111111111111111111 11111 11111111 1111111111111111111111111 11 1111111111111111111111
1111111111111111111 11111 11111111 1111111111111111111111111 11 11111111111111111111
1111111111111111111 11111 11111111 1111111111111111111111111 11 11111111111111111111
1111111111111111111 11111 11111111 1111111111111111111111111 11 111111111111111111111
1111111111111111111 11111 11111111 111111            1111111 11 111111111111111111
1111111111111111111 11111 11111111 111111 1111111111 1111111 11 11111111111111111
1111111111111111111 11111 11111111 111111 111101     1111111 11 111111111111111111
1111111111111111111 11111 111             1111111111 1111111 11 11111111111111111111111
1111111111111111111 11111 111111111111111 1111111111 1111111 11 111111111111111111
1111111111111111111 11111 111111111111111 111111111111111111 11 111111111111111
1111111111111111111 1111111111111111111111111111111111111111 11 11111111111111111
1111111111111111111 1111111111111111111111111111111111111111 11 111111111111111
1111111111111111111 1111111111111111111111111111111111111111 11 11111111111111111
1111111111111111111                                          11 11111111111111111
111111111111111111111111111111111111111111111111111111111111111 1111111111111111
111111111111111111111111111111111111111111111111111111111111111 11111111111
11111111111100000000000000111111111111111111111111111111111111 111111111111111
111111111111111111111111111111111111111111111111111111111111111 11111111111111111
11111111111111111111111111111111111111111111111111111111111111111