NO textures/wall_1.xpm
SO textures/forest_1.xpm

WE textures/jail_1.xpm
EA textures/maif_1.xpm

F 18,    53,   25
C 153,     204,    255

1111111111111
1111110000001
1000000000011     111111
111000N000011     1000001
1001101100001     11111101
11100000000111          1
1100010000011111111111111
111111111111111111111111111111111111111111111111111111111
11111
100001
111111111111111111111111111111111111111