NO textures/grey_stone.xpm
SO textures/purple_stone.xpm

WE textures/red_brick.xpm
EA textures/black_brick.xpm

F 18,    53,   25
C 153,     204,    255

1111111111111
1111110000001
10000N0000011     111111
1110000000011     1000001
1000000000001     11111101
1110011111111           1
11000000000111111111111101
111111111111111111111111111111111111111111111111111111111
11111
100001
111111111111111111111111111111111111111