NO textures/grey_stone.xpm
SO textures/purple_stone.xpm
         
WE textures/red_brick.xpm
EA textures/black_brick.xpm

             

F 18,    53,   25
C 153,     204,    255

111111111111
11  10000001
1   1000001  111111
111100001111  10001
10W000001  1  1111
111111000111  1
1111001111
11000111   1
111111     1   11
111111111111