        NO              textures/grey_stone.xpm   
SO textures/purple_stone.xpm                 
WE              textures/red_brick.xpm
 EA  textures/black_brick.xpm 

      


F 18,    53,   25    
C 153,     204,    255     









111111111111   111  1111111
111110001001   101   1101111
100000011001   111     1
111000000001
10S000000001
111111000001
110000000001  111111111111111
111111111111  100000000000001
              111111111111111111111111