        NO              textures/jail_1.xpm   
SO textures/wall_3.xpm                 
WE              textures/forest_1.xpm
 EA  textures/wall_3.xpm 

      


F 18,    53,   25    
C 153,     204,    255    



111111111111
101111111101
100000000001
100010010001
100000011111
11110011 111
100000011101
101111111111
101
101
101
101
101
101
101111111111
101111111101
100000000001
100010010001
100000011111
11110111 111
100000011101
101111111111
101
101
101
101
101
101
101111111111
101111111101
100000000001
100010010001
10S000011111
11011111 111
100000011101
101111111111
101
101111111111
101111111101
100000000001
100010010001
100000011111
11000111 111
100000011101
111111111111