        NO              textures/grey_stone.xpm   
SO textures/purple_stone.xpm                 
WE              textures/red_brick.xpm
 EA  textures/black_brick.xpm 

      


F 18,    53,   25    
C 153,     204,    255    



111111111111
101111111101
100000000001
100010010001
100000011111
11111111 111
100000011101
111111111111


111111111111
101111111101
100000000001
100010010001
100000011111
11111111 111
100000011101
111111111111


111111111111
101111111101
100000000001
100010010001
10S000011111
11111111 111
100000011101
111111111111

111111111111
101111111101
100000000001
100010010001
100000011111
11111111 111
100000011101
111111111111