        NO              textures/grey_stone.xpm   
SO textures/purple_stone.xpm                 
WE              textures/red_brick.xpm
 EA  textures/black_brick.xpm 

      


F 18,    53,   25    
C 153,     204,    255    









111111111111
101111111101
100000000001
100000000001
100000000001
110000000001111111111111111111111111111111111111111111111111111111111111111
100000000000000000000000000000000000000000000000000000000000000000000000001
100000000000000000000000000000000000000000000000000000000000000000000000001
100000000000000000000000000000000000000000000000000000000000000000000000001
1000000S0000000010000000000000000000000000000000000000000000000000000000001
100000000000000100000000000000000000000000000000000000000000000000000000001
100000000000000000000000000000000000000000000000000000000000000000000000001
100000000000000000000000000000000000000000000000000000000000000000000000001
100000000000000000000000000000000000000000000000000000000000000000000000001
100000011101111111111111111111111111111111111111111111111111111111111111111
10000001 101
10000001 101
10000001 101
10000001 101
10000001 101
10000001 101
10001001 101
100000011111
11111111 111
100000011101
111111111111