        NO              textures/grey_stone.xpm   
SO textures/purple_stone.xpm                 
WE              textures/red_brick.xpm
 EA  textures/black_brick.xpm 

      


F 18,    53,   25    
C 153,     204,    255    









1111111
1000001
1000101
100W001
1000001
1000001
111111