        NO              textures/wall_2.xpm   
SO textures/wall_4.xpm                 
WE              textures/forest_4.xpm
                                                             EA  textures/jail_3.xpm 

F 18,    53,   25    
C 153,     204,    255    









1111111
1N01001
1000101
1000001
1100001
1000001
111111