        NO              textures/forest_1.xpm   
SO textures/forest_3.xpm                 
WE              textures/forest_2.xpm
 EA  textures/forest_4.xpm 

      


F 128,    146,   109    
C 142,     181,    224   









111111111111
100000000001
100000000001
100000000001
10000N100001
100000000001
100000000001
100000000001
100000000001
100000000101
100000000101
100000011001
111111111111