        NO              textures/jail_1.xpm   
SO textures/jail_2.xpm                 
WE              textures/jail_3.xpm
 EA  textures/jail_4.xpm 

      


F 111,    123,   128    
C 117,     104,    83    









111111111111
100000000001
100000000001
100111111001
10000N100001
100000100001
100000000001
100001000001
100000000001
100000000101
100000000101
100000011001
111111111111