        NO              textures/maif_1.xpm   
SO textures/maif_2.xpm                 
WE              textures/maif_3.xpm
 EA  textures/maif_4.xpm 

      


F 103,    164,   166    
C 242,     227,    242    









111111111111
100000000001
100000000001
100000000001
10000N000001
100000100001
100000000001
100000000001
100000000001
100000000101
100000000101
100000011001
111111111111