        NO              textures/grey_stone.xpm   
SO textures/purple_stone.xpm                 
WE              textures/red_brick.xpm
 EA  textures/black_brick.xpm 

      


F 18,    53,   25    
C 153,     204,    255    









111111111
100011111
100011E11
100011111
100011111
101001001
100000011
100000001
111111111