        NO              textures/grey_stone.xpm   
SO textures/purple_stone.xpm                 
WE              textures/red_brick.xpm
 EA  textures/black_brick.xpm 

      


F 18,    53,   25    
C 153,     204,    255    









111111111
101000011
101000001
10100N001
101000001
101000001
101111111
100000011
100000001
111111111