        NO              textures/wall_1.xpm   
SO textures/wall_2.xpm                
WE              textures/wall_3.xpm
 EA  textures/wall_4.xpm

      


F 18,    53,   25    
C 153,     204,    255    









111111111111111111
111000000000011111
1110000N0000011111
111000000000011111
111111111111111111