NO textures/grey_stone.xpm
SO textures/purple_stone.xpm

WE textures/red_brick.xpm
EA textures/black_brick.xpm

F 18,    53,   25
C 153,     204,    255

1111111111111
1111110000001
10000N0000011     111111
1110000000011     1000001
1000000000001     111 11011
1110011111111   11001 1000011
11111111111      1111 111111
1111111          1 1  1 1 1

111111        1
100001
111111