NO textures/grey_stone.xpm
SO textures/purple_stone.xpm     
    
WE textures/red_brick.xpm
EA textures/black_brick.xpm
    
F 18, 53, 25,
C 153,204,255

111111111111
1111110000001
100000000001          111111
111000001111111111111111111011         
10N00000100000000111111111011
11100111111111111111111111111
11001   1000011
1111111111111