NO textures/grey_stone.xpm
SO textures/purple_stone.xpm     
    
WE textures/red_brick.xpm
EA textures/black_brick.xpm
    

F 18, 53, 25
C 153,204,255


 11111
10001
11001
10001
1N0E1
11111

