NO textures/grey_stone.xpm
SO textures/purple_stone.xpm     
    
WE textures/red_brick.xpm
EA textures/black_brick.xpm
    
F 18, 53, 25,
C 153,204,255




111111101111
100000000001
     100000000001
111000001111           100001
10S000000001           111111
111111000001
110000000001
111111111111