NO textures/grey_stone.xpm
SO textures/purple_stone.xpm     
    
WE textures/red_brick.xpm
EA textures/black_brick.xpm
    
F 18, 53, 25,
C 153,204,255




111111111111
1111110000001
100000000001           111111
111000001111          100001
10N000001001           111111
111001111111
11001   000011
111111111111